@###########################
.....#.....................#
####.#....#..############..#
#..#.######..#..........#..#
#..#.........#...#####..#..#
#..###########...#...#..#..#
#....................#.....#
############....############
#..................#.......#
#...........#..#...#.......#
#...........#..########.####
#..##########..............#
#...........################
#..........................#
#####################...####
#........................#.#
<........................#.#
##########################.#
#...save..me...............#
#..........................#
############################
